E E E E _ _ _ _ _ _ _ _ _ _ _
_ _ _ _ _ _ S S S _ S S S _ _
P _ _ _ _ _ S S S _ S S S _ _
_ _ _ _ _ _ _ _ _ _ _ _ _ _ _
_ _ S S S _ S S S _ S S S _ _
_ _ S S S _ S S S _ S S S _ _
_ _ _ _ _ _ _ _ _ _ _ _ _ _ _
_ _ S S S _ S S S _ S S S _ _
_ _ S S S _ S S S _ S S S _ _
_ _ _ _ _ _ _ _ _ _ _ _ _ _ _
_ _ S S S _ S S S _ S S S _ _
_ _ S S S _ S S S _ S S S _ _
_ _ _ _ _ _ _ _ _ _ _ _ _ _ _
_ _ S S S S S S S _ _ _ _ _ _
_ _ _ _ _ _ _ _ _ _ _ _ _ D _
