_ _ _ S S S _ _ _ S S S _ _ _
_ _ _ S _ S _ _ _ S _ S _ _ _
_ _ _ S _ S _ _ _ S _ S _ _ _
_ _ _ S S S _ _ _ S S S _ _ _
_ _ _ _ _ _ _ _ _ _ _ _ _ _ _
S S S _ _ _ S S S _ _ _ S S S
S _ S _ _ _ S _ S _ _ _ S _ S
S _ S _ _ _ S _ S _ _ _ S _ S
S S S _ _ _ S S S _ _ _ S S S
_ _ _ _ _ _ _ _ _ _ _ _ _ _ _
_ _ _ S S S _ _ _ S S S _ _ _
_ _ _ S _ S _ _ _ S _ S _ _ _
_ _ _ S _ S _ _ _ S _ S _ _ _
_ _ _ S S S _ _ _ S S S _ _ _
P _ _ _ _ _ _ _ _ _ _ _ _ _ D
