E _ _ _ _ _ _ _ _ _ _ _ _ _ _
E _ _ S S _ _ S S _ _ S S _ _
E _ _ S S _ _ S S _ _ S S _ _
E _ _ S S _ _ S S _ _ S S _ _
_ _ _ S S _ _ S S _ _ S S _ _
_ _ _ S S _ _ S S _ _ S S _ _
P _ _ S S _ _ S S _ _ S S _ _
_ _ _ S S _ _ S S _ _ S S _ _
_ _ _ S S _ _ S S _ _ S S _ _
_ _ _ S S _ _ S S _ _ S S _ _
D _ _ S S _ _ S S _ _ S S _ _
_ _ _ S S _ _ S S _ _ S S _ _
_ _ _ S S _ _ S S _ _ S S _ _
_ _ _ S S _ _ S S _ _ S S _ _
_ _ _ _ _ _ _ _ _ _ _ _ _ _ _
